,Time,S&H,ECE,CSE,EEE,CT,AUTO,Total
0,2024-01-01 00:00:00,9,9,10,7,10,11,56
1,2024-01-01 01:00:00,5,5,11,14,6,10,51
2,2024-01-01 02:00:00,9,6,10,5,6,9,45
3,2024-01-01 03:00:00,11,14,6,11,14,5,61
4,2024-01-01 04:00:00,13,9,14,9,9,8,62
5,2024-01-01 05:00:00,7,5,6,14,12,6,50
6,2024-01-01 06:00:00,10,8,6,11,8,12,55
7,2024-01-01 07:00:00,6,14,13,7,11,14,65
8,2024-01-01 08:00:00,11,5,11,13,10,9,59
9,2024-01-01 09:00:00,6,14,11,12,10,9,62
10,2024-01-01 10:00:00,10,10,12,13,11,5,61
11,2024-01-01 11:00:00,8,14,9,9,12,6,58
12,2024-01-01 12:00:00,9,5,13,14,13,10,64
13,2024-01-01 13:00:00,7,11,6,8,12,13,57
14,2024-01-01 14:00:00,6,13,7,7,7,5,45
15,2024-01-01 15:00:00,9,11,8,5,10,6,49
16,2024-01-01 16:00:00,11,7,9,9,7,10,53
17,2024-01-01 17:00:00,5,8,10,5,10,10,48
18,2024-01-01 18:00:00,12,11,8,10,13,11,65
19,2024-01-01 19:00:00,11,10,12,10,7,12,62
20,2024-01-01 20:00:00,9,5,12,6,6,14,52
21,2024-01-01 21:00:00,9,10,8,13,11,12,63
22,2024-01-01 22:00:00,14,13,7,8,10,12,64
23,2024-01-01 23:00:00,8,13,8,12,7,5,53
24,2024-01-02 00:00:00,11,11,14,13,6,7,62
25,2024-01-02 01:00:00,6,11,6,14,7,13,57
26,2024-01-02 02:00:00,13,12,12,12,13,9,71
27,2024-01-02 03:00:00,7,13,10,7,8,13,58
28,2024-01-02 04:00:00,5,11,10,13,7,8,54
29,2024-01-02 05:00:00,9,6,7,7,10,11,50
30,2024-01-02 06:00:00,10,6,9,11,12,11,59
31,2024-01-02 07:00:00,10,5,10,13,9,8,55
32,2024-01-02 08:00:00,6,7,7,13,6,5,44
33,2024-01-02 09:00:00,14,13,7,14,7,5,60
34,2024-01-02 10:00:00,14,7,7,8,10,7,53
35,2024-01-02 11:00:00,10,11,5,10,10,11,57
36,2024-01-02 12:00:00,10,11,7,13,14,11,66
37,2024-01-02 13:00:00,10,7,7,7,12,10,53
38,2024-01-02 14:00:00,12,8,8,14,14,10,66
39,2024-01-02 15:00:00,13,14,8,11,9,12,67
40,2024-01-02 16:00:00,5,6,11,5,13,9,49
41,2024-01-02 17:00:00,12,5,5,11,7,8,48
42,2024-01-02 18:00:00,14,5,6,12,9,5,51
43,2024-01-02 19:00:00,12,6,8,7,10,7,50
44,2024-01-02 20:00:00,10,8,8,6,11,14,57
45,2024-01-02 21:00:00,11,11,10,6,13,6,57
46,2024-01-02 22:00:00,11,14,9,5,7,14,60
47,2024-01-02 23:00:00,13,10,6,8,8,11,56
48,2024-01-03 00:00:00,5,8,10,7,7,8,45
49,2024-01-03 01:00:00,7,9,12,6,10,8,52
50,2024-01-03 02:00:00,14,6,10,6,11,9,56
51,2024-01-03 03:00:00,8,14,8,10,12,13,65
52,2024-01-03 04:00:00,7,6,8,10,9,12,52
53,2024-01-03 05:00:00,7,13,5,8,14,7,54
54,2024-01-03 06:00:00,8,6,6,13,12,10,55
55,2024-01-03 07:00:00,11,10,5,5,13,11,55
56,2024-01-03 08:00:00,8,12,9,10,13,11,63
57,2024-01-03 09:00:00,7,11,10,7,12,12,59
58,2024-01-03 10:00:00,5,6,12,13,5,13,54
59,2024-01-03 11:00:00,13,9,9,9,11,14,65
60,2024-01-03 12:00:00,12,11,14,5,12,8,62
61,2024-01-03 13:00:00,13,8,6,14,6,6,53
62,2024-01-03 14:00:00,5,6,5,7,8,14,45
63,2024-01-03 15:00:00,12,13,5,14,5,10,59
64,2024-01-03 16:00:00,8,11,6,9,13,12,59
65,2024-01-03 17:00:00,9,8,13,8,12,13,63
66,2024-01-03 18:00:00,7,6,14,7,12,10,56
67,2024-01-03 19:00:00,8,8,14,10,14,8,62
68,2024-01-03 20:00:00,14,11,7,5,13,5,55
69,2024-01-03 21:00:00,13,7,5,10,12,14,61
70,2024-01-03 22:00:00,7,10,10,9,11,6,53
71,2024-01-03 23:00:00,14,9,12,14,6,5,60
72,2024-01-04 00:00:00,14,11,7,12,9,12,65
73,2024-01-04 01:00:00,12,7,6,14,14,7,60
74,2024-01-04 02:00:00,14,9,11,9,6,8,57
75,2024-01-04 03:00:00,7,10,9,14,6,6,52
76,2024-01-04 04:00:00,10,8,8,8,6,13,53
77,2024-01-04 05:00:00,7,7,10,5,9,11,49
78,2024-01-04 06:00:00,8,14,14,14,7,5,62
79,2024-01-04 07:00:00,6,9,7,14,14,12,62
80,2024-01-04 08:00:00,10,13,7,8,6,14,58
81,2024-01-04 09:00:00,13,14,8,7,6,11,59
82,2024-01-04 10:00:00,12,9,9,9,7,7,53
83,2024-01-04 11:00:00,8,9,7,5,14,11,54
84,2024-01-04 12:00:00,8,11,11,9,5,6,50
85,2024-01-04 13:00:00,7,5,14,12,5,8,51
86,2024-01-04 14:00:00,14,10,10,10,7,11,62
87,2024-01-04 15:00:00,5,12,8,12,7,10,54
88,2024-01-04 16:00:00,6,13,10,7,13,12,61
89,2024-01-04 17:00:00,8,8,14,9,14,5,58
90,2024-01-04 18:00:00,11,9,9,10,14,8,61
91,2024-01-04 19:00:00,8,10,11,10,11,8,58
92,2024-01-04 20:00:00,7,13,7,7,12,8,54
93,2024-01-04 21:00:00,9,11,10,8,13,8,59
94,2024-01-04 22:00:00,12,7,6,8,7,6,46
95,2024-01-04 23:00:00,10,5,12,9,13,13,62
96,2024-01-05 00:00:00,5,8,8,14,5,12,52
97,2024-01-05 01:00:00,6,7,9,8,11,8,49
98,2024-01-05 02:00:00,6,9,10,8,14,14,61
99,2024-01-05 03:00:00,8,14,10,11,14,9,66
100,2024-01-05 04:00:00,10,14,7,12,6,8,57
101,2024-01-05 05:00:00,5,11,13,7,9,5,50
102,2024-01-05 06:00:00,7,14,8,5,13,7,54
103,2024-01-05 07:00:00,5,9,10,13,13,13,63
104,2024-01-05 08:00:00,6,11,12,14,8,5,56
105,2024-01-05 09:00:00,5,7,5,12,7,13,49
106,2024-01-05 10:00:00,6,5,14,5,5,11,46
107,2024-01-05 11:00:00,14,9,12,13,10,6,64
108,2024-01-05 12:00:00,12,14,12,8,6,13,65
109,2024-01-05 13:00:00,9,11,11,7,7,13,58
110,2024-01-05 14:00:00,11,14,14,8,8,10,65
111,2024-01-05 15:00:00,12,9,7,7,14,14,63
112,2024-01-05 16:00:00,7,10,13,11,5,11,57
113,2024-01-05 17:00:00,11,13,12,7,8,13,64
114,2024-01-05 18:00:00,6,14,11,14,12,10,67
115,2024-01-05 19:00:00,5,10,13,11,7,14,60
116,2024-01-05 20:00:00,10,10,9,13,14,13,69
117,2024-01-05 21:00:00,6,11,9,12,9,11,58
118,2024-01-05 22:00:00,8,5,14,7,9,13,56
119,2024-01-05 23:00:00,7,10,7,10,11,13,58
120,2024-01-06 00:00:00,11,7,11,11,9,8,57
121,2024-01-06 01:00:00,10,6,12,7,5,10,50
122,2024-01-06 02:00:00,10,12,6,13,13,9,63
123,2024-01-06 03:00:00,5,9,10,14,11,11,60
124,2024-01-06 04:00:00,14,10,8,12,14,6,64
125,2024-01-06 05:00:00,5,13,9,5,5,11,48
126,2024-01-06 06:00:00,14,8,12,10,13,11,68
127,2024-01-06 07:00:00,6,11,7,9,10,6,49
128,2024-01-06 08:00:00,12,6,10,8,13,8,57
129,2024-01-06 09:00:00,13,13,13,5,11,12,67
130,2024-01-06 10:00:00,5,9,14,12,7,11,58
131,2024-01-06 11:00:00,5,8,10,7,14,8,52
132,2024-01-06 12:00:00,7,5,7,8,11,13,51
133,2024-01-06 13:00:00,7,11,11,13,7,13,62
134,2024-01-06 14:00:00,6,13,11,5,13,10,58
135,2024-01-06 15:00:00,7,11,12,6,8,7,51
136,2024-01-06 16:00:00,5,10,6,7,7,9,44
137,2024-01-06 17:00:00,7,8,14,14,9,12,64
138,2024-01-06 18:00:00,5,11,6,5,12,11,50
139,2024-01-06 19:00:00,13,8,10,6,12,12,61
140,2024-01-06 20:00:00,12,10,14,6,6,11,59
141,2024-01-06 21:00:00,14,13,6,13,5,5,56
142,2024-01-06 22:00:00,10,7,13,8,10,12,60
143,2024-01-06 23:00:00,6,13,5,8,11,12,55
144,2024-01-07 00:00:00,13,9,14,13,7,10,66
145,2024-01-07 01:00:00,5,13,13,13,12,12,68
146,2024-01-07 02:00:00,5,14,9,10,7,14,59
147,2024-01-07 03:00:00,6,14,10,5,12,5,52
148,2024-01-07 04:00:00,10,13,14,10,14,5,66
149,2024-01-07 05:00:00,6,9,5,8,8,10,46
150,2024-01-07 06:00:00,14,12,7,11,14,8,66
151,2024-01-07 07:00:00,14,9,14,6,7,9,59
152,2024-01-07 08:00:00,7,6,5,10,10,10,48
153,2024-01-07 09:00:00,11,11,9,13,14,8,66
154,2024-01-07 10:00:00,5,10,9,11,11,8,54
155,2024-01-07 11:00:00,11,12,12,5,13,13,66
156,2024-01-07 12:00:00,13,5,7,5,8,5,43
157,2024-01-07 13:00:00,7,12,6,10,14,9,58
158,2024-01-07 14:00:00,8,6,10,6,13,13,56
159,2024-01-07 15:00:00,9,14,12,8,11,8,62
160,2024-01-07 16:00:00,12,11,5,12,10,13,63
161,2024-01-07 17:00:00,12,7,6,10,8,14,57
162,2024-01-07 18:00:00,13,9,9,12,5,14,62
163,2024-01-07 19:00:00,7,5,6,12,11,7,48
164,2024-01-07 20:00:00,5,13,7,11,12,13,61
165,2024-01-07 21:00:00,9,8,12,11,6,12,58
166,2024-01-07 22:00:00,11,9,13,7,14,5,59
167,2024-01-07 23:00:00,9,14,8,14,7,14,66
168,2024-01-08 00:00:00,14,6,13,13,13,5,64
169,2024-01-08 01:00:00,6,9,7,13,12,10,57
170,2024-01-08 02:00:00,13,5,14,10,11,13,66
171,2024-01-08 03:00:00,13,7,7,14,8,10,59
172,2024-01-08 04:00:00,11,7,6,12,11,6,53
173,2024-01-08 05:00:00,14,12,14,8,10,12,70
174,2024-01-08 06:00:00,6,7,7,5,5,7,37
175,2024-01-08 07:00:00,13,7,11,11,7,6,55
176,2024-01-08 08:00:00,6,9,11,12,14,11,63
177,2024-01-08 09:00:00,9,13,5,12,5,8,52
178,2024-01-08 10:00:00,6,6,6,13,12,14,57
179,2024-01-08 11:00:00,9,9,7,12,5,8,50
180,2024-01-08 12:00:00,12,9,6,11,13,6,57
181,2024-01-08 13:00:00,13,9,7,11,14,9,63
182,2024-01-08 14:00:00,7,6,12,7,7,9,48
183,2024-01-08 15:00:00,5,5,11,8,9,5,43
184,2024-01-08 16:00:00,5,12,12,7,11,6,53
185,2024-01-08 17:00:00,13,12,12,10,6,10,63
186,2024-01-08 18:00:00,6,5,5,10,14,11,51
187,2024-01-08 19:00:00,6,10,9,5,7,9,46
188,2024-01-08 20:00:00,14,10,11,6,13,5,59
189,2024-01-08 21:00:00,13,9,11,6,7,14,60
190,2024-01-08 22:00:00,6,13,12,5,5,14,55
191,2024-01-08 23:00:00,9,6,5,14,9,10,53
192,2024-01-09 00:00:00,9,7,11,5,12,13,57
193,2024-01-09 01:00:00,7,9,9,8,11,14,58
194,2024-01-09 02:00:00,9,7,8,6,5,10,45
195,2024-01-09 03:00:00,14,8,5,5,7,9,48
196,2024-01-09 04:00:00,7,13,11,6,6,5,48
197,2024-01-09 05:00:00,8,7,14,10,11,10,60
198,2024-01-09 06:00:00,9,10,13,6,5,14,57
199,2024-01-09 07:00:00,13,10,11,11,9,14,68
200,2024-01-09 08:00:00,6,5,5,13,14,6,49
201,2024-01-09 09:00:00,8,7,12,12,13,6,58
202,2024-01-09 10:00:00,5,12,13,14,8,11,63
203,2024-01-09 11:00:00,9,10,10,11,11,5,56
204,2024-01-09 12:00:00,10,7,14,9,12,10,62
205,2024-01-09 13:00:00,8,5,11,8,8,10,50
206,2024-01-09 14:00:00,6,6,8,5,13,5,43
207,2024-01-09 15:00:00,12,6,14,5,8,14,59
208,2024-01-09 16:00:00,14,8,14,12,10,8,66
209,2024-01-09 17:00:00,12,8,5,5,12,9,51
210,2024-01-09 18:00:00,5,6,9,12,5,7,44
211,2024-01-09 19:00:00,7,6,5,7,12,13,50
212,2024-01-09 20:00:00,12,9,8,5,12,11,57
213,2024-01-09 21:00:00,11,13,6,8,11,13,62
214,2024-01-09 22:00:00,6,12,12,6,6,12,54
215,2024-01-09 23:00:00,10,9,13,7,11,13,63
216,2024-01-10 00:00:00,14,10,7,14,5,12,62
217,2024-01-10 01:00:00,10,14,5,8,12,14,63
218,2024-01-10 02:00:00,10,9,7,9,9,13,57
219,2024-01-10 03:00:00,13,6,8,13,14,9,63
220,2024-01-10 04:00:00,9,11,7,13,5,12,57
221,2024-01-10 05:00:00,8,8,11,11,11,14,63
222,2024-01-10 06:00:00,14,9,14,7,5,14,63
223,2024-01-10 07:00:00,13,6,8,14,7,14,62
224,2024-01-10 08:00:00,14,9,12,12,13,8,68
225,2024-01-10 09:00:00,10,11,8,11,5,5,50
226,2024-01-10 10:00:00,14,10,14,14,9,13,74
227,2024-01-10 11:00:00,6,8,8,9,13,12,56
228,2024-01-10 12:00:00,12,13,7,10,6,9,57
229,2024-01-10 13:00:00,12,5,11,12,6,7,53
230,2024-01-10 14:00:00,9,12,7,9,7,5,49
231,2024-01-10 15:00:00,7,12,14,11,5,10,59
232,2024-01-10 16:00:00,7,14,8,5,12,14,60
233,2024-01-10 17:00:00,13,9,11,8,10,11,62
234,2024-01-10 18:00:00,13,10,6,9,13,11,62
235,2024-01-10 19:00:00,8,9,8,7,14,8,54
236,2024-01-10 20:00:00,14,5,9,6,10,13,57
237,2024-01-10 21:00:00,14,7,9,9,7,13,59
238,2024-01-10 22:00:00,11,12,8,14,14,8,67
239,2024-01-10 23:00:00,11,10,9,5,7,6,48
240,2024-01-11 00:00:00,10,12,9,12,11,9,63
241,2024-01-11 01:00:00,9,9,10,11,8,5,52
242,2024-01-11 02:00:00,5,8,14,11,11,13,62
243,2024-01-11 03:00:00,11,10,10,6,12,9,58
244,2024-01-11 04:00:00,9,9,12,5,9,10,54
245,2024-01-11 05:00:00,12,14,12,5,14,8,65
246,2024-01-11 06:00:00,10,6,6,9,5,5,41
247,2024-01-11 07:00:00,11,11,7,7,12,13,61
248,2024-01-11 08:00:00,8,7,14,8,12,12,61
249,2024-01-11 09:00:00,14,12,8,13,7,6,60
250,2024-01-11 10:00:00,14,12,12,14,14,11,77
251,2024-01-11 11:00:00,9,10,7,13,9,5,53
252,2024-01-11 12:00:00,8,8,8,5,10,7,46
253,2024-01-11 13:00:00,8,5,10,6,5,12,46
254,2024-01-11 14:00:00,13,12,9,8,7,14,63
255,2024-01-11 15:00:00,11,8,11,5,6,6,47
256,2024-01-11 16:00:00,10,8,11,6,8,10,53
257,2024-01-11 17:00:00,11,11,9,12,5,12,60
258,2024-01-11 18:00:00,12,9,13,8,14,6,62
259,2024-01-11 19:00:00,14,7,5,12,7,14,59
260,2024-01-11 20:00:00,14,6,9,8,5,7,49
261,2024-01-11 21:00:00,11,12,8,10,11,13,65
262,2024-01-11 22:00:00,6,13,14,10,7,9,59
263,2024-01-11 23:00:00,8,10,7,13,9,10,57
264,2024-01-12 00:00:00,10,7,6,11,13,11,58
265,2024-01-12 01:00:00,10,11,14,12,12,5,64
266,2024-01-12 02:00:00,5,14,8,8,9,6,50
267,2024-01-12 03:00:00,7,9,6,6,5,13,46
268,2024-01-12 04:00:00,6,11,14,7,8,5,51
269,2024-01-12 05:00:00,11,7,5,14,7,9,53
270,2024-01-12 06:00:00,5,5,12,14,6,10,52
271,2024-01-12 07:00:00,12,6,11,14,11,5,59
272,2024-01-12 08:00:00,13,8,8,7,9,12,57
273,2024-01-12 09:00:00,7,8,11,8,11,8,53
274,2024-01-12 10:00:00,10,9,7,7,14,13,60
275,2024-01-12 11:00:00,12,13,6,6,5,14,56
276,2024-01-12 12:00:00,5,12,11,14,14,9,65
277,2024-01-12 13:00:00,12,6,11,9,11,13,62
278,2024-01-12 14:00:00,8,9,13,13,5,10,58
279,2024-01-12 15:00:00,13,14,5,14,7,13,66
280,2024-01-12 16:00:00,14,7,8,11,6,11,57
281,2024-01-12 17:00:00,7,12,14,9,8,12,62
282,2024-01-12 18:00:00,7,13,14,12,6,13,65
283,2024-01-12 19:00:00,7,11,14,12,7,6,57
284,2024-01-12 20:00:00,5,10,8,12,14,8,57
285,2024-01-12 21:00:00,12,10,6,8,10,14,60
286,2024-01-12 22:00:00,7,14,9,14,10,8,62
287,2024-01-12 23:00:00,6,7,6,5,6,10,40
288,2024-01-13 00:00:00,9,12,7,14,12,7,61
289,2024-01-13 01:00:00,12,12,14,14,14,8,74
290,2024-01-13 02:00:00,12,13,11,10,8,9,63
291,2024-01-13 03:00:00,5,9,14,7,12,12,59
292,2024-01-13 04:00:00,11,7,13,8,13,11,63
293,2024-01-13 05:00:00,8,6,13,9,5,11,52
294,2024-01-13 06:00:00,11,9,14,5,6,5,50
295,2024-01-13 07:00:00,13,7,9,13,9,14,65
296,2024-01-13 08:00:00,8,11,5,14,12,7,57
297,2024-01-13 09:00:00,10,14,8,13,9,12,66
298,2024-01-13 10:00:00,14,5,5,9,7,12,52
299,2024-01-13 11:00:00,10,14,7,14,5,12,62
300,2024-01-13 12:00:00,14,13,9,12,13,5,66
301,2024-01-13 13:00:00,8,5,11,10,11,8,53
302,2024-01-13 14:00:00,14,11,13,8,12,11,69
303,2024-01-13 15:00:00,13,11,6,6,10,5,51
304,2024-01-13 16:00:00,9,14,12,11,6,6,58
305,2024-01-13 17:00:00,10,9,13,6,12,10,60
306,2024-01-13 18:00:00,5,5,13,6,14,5,48
307,2024-01-13 19:00:00,11,8,7,9,14,12,61
308,2024-01-13 20:00:00,5,5,11,7,10,10,48
309,2024-01-13 21:00:00,11,12,10,8,5,5,51
310,2024-01-13 22:00:00,10,5,14,14,14,7,64
311,2024-01-13 23:00:00,7,7,11,9,11,12,57
312,2024-01-14 00:00:00,10,12,11,10,10,14,67
313,2024-01-14 01:00:00,8,12,11,14,11,7,63
314,2024-01-14 02:00:00,14,12,5,9,11,9,60
315,2024-01-14 03:00:00,11,10,9,11,9,8,58
316,2024-01-14 04:00:00,6,9,9,10,10,10,54
317,2024-01-14 05:00:00,13,7,5,6,9,9,49
318,2024-01-14 06:00:00,14,7,7,14,9,12,63
319,2024-01-14 07:00:00,6,8,13,11,8,10,56
320,2024-01-14 08:00:00,10,6,12,11,8,9,56
321,2024-01-14 09:00:00,12,5,7,13,10,8,55
322,2024-01-14 10:00:00,10,5,7,14,6,7,49
323,2024-01-14 11:00:00,6,8,14,9,6,7,50
324,2024-01-14 12:00:00,9,14,13,10,7,8,61
325,2024-01-14 13:00:00,7,8,7,8,10,5,45
326,2024-01-14 14:00:00,10,8,13,14,8,9,62
327,2024-01-14 15:00:00,14,12,11,10,12,14,73
328,2024-01-14 16:00:00,14,6,9,11,8,14,62
329,2024-01-14 17:00:00,13,13,6,9,8,13,62
330,2024-01-14 18:00:00,7,6,11,6,11,5,46
331,2024-01-14 19:00:00,7,9,6,13,13,14,62
332,2024-01-14 20:00:00,12,5,8,7,13,8,53
333,2024-01-14 21:00:00,8,8,7,10,8,10,51
334,2024-01-14 22:00:00,11,5,8,9,11,13,57
335,2024-01-14 23:00:00,10,14,9,12,5,11,61
336,2024-01-15 00:00:00,14,5,10,6,10,13,58
337,2024-01-15 01:00:00,5,10,7,5,8,13,48
338,2024-01-15 02:00:00,5,14,12,10,5,5,51
339,2024-01-15 03:00:00,10,14,9,6,5,8,52
340,2024-01-15 04:00:00,13,6,14,10,8,12,63
341,2024-01-15 05:00:00,9,8,12,6,5,11,51
342,2024-01-15 06:00:00,11,10,8,11,7,9,56
343,2024-01-15 07:00:00,9,14,13,7,6,9,58
344,2024-01-15 08:00:00,7,5,12,8,5,6,43
345,2024-01-15 09:00:00,5,14,7,11,6,13,56
346,2024-01-15 10:00:00,10,6,6,5,12,5,44
347,2024-01-15 11:00:00,9,12,7,7,13,14,62
348,2024-01-15 12:00:00,11,9,10,8,14,14,66
349,2024-01-15 13:00:00,14,13,13,5,9,10,64
350,2024-01-15 14:00:00,6,9,12,14,12,10,63
351,2024-01-15 15:00:00,12,8,5,12,6,6,49
352,2024-01-15 16:00:00,9,10,13,8,5,14,59
353,2024-01-15 17:00:00,5,11,5,12,11,8,52
354,2024-01-15 18:00:00,10,14,6,9,6,5,50
355,2024-01-15 19:00:00,7,8,6,13,14,6,54
356,2024-01-15 20:00:00,11,12,13,6,11,12,65
357,2024-01-15 21:00:00,12,14,8,9,9,6,58
358,2024-01-15 22:00:00,8,7,6,6,7,12,46
359,2024-01-15 23:00:00,10,13,9,6,13,9,60
360,2024-01-16 00:00:00,12,13,13,6,10,6,60
361,2024-01-16 01:00:00,14,5,14,10,10,13,66
362,2024-01-16 02:00:00,11,12,9,11,12,7,62
363,2024-01-16 03:00:00,9,6,8,14,11,7,55
364,2024-01-16 04:00:00,7,13,8,5,11,7,51
365,2024-01-16 05:00:00,5,14,6,9,8,9,51
366,2024-01-16 06:00:00,14,5,5,6,14,11,55
367,2024-01-16 07:00:00,11,5,14,5,10,8,53
368,2024-01-16 08:00:00,5,10,8,13,13,12,61
369,2024-01-16 09:00:00,10,8,6,7,11,7,49
370,2024-01-16 10:00:00,12,14,7,7,14,14,68
371,2024-01-16 11:00:00,14,5,10,13,14,11,67
372,2024-01-16 12:00:00,12,13,9,5,12,10,61
373,2024-01-16 13:00:00,7,11,10,10,5,7,50
374,2024-01-16 14:00:00,9,5,6,14,10,14,58
375,2024-01-16 15:00:00,8,14,6,10,7,7,52
376,2024-01-16 16:00:00,14,10,6,12,6,14,62
377,2024-01-16 17:00:00,12,8,14,11,5,8,58
378,2024-01-16 18:00:00,12,11,14,13,6,14,70
379,2024-01-16 19:00:00,13,5,6,11,13,12,60
380,2024-01-16 20:00:00,5,13,6,8,14,13,59
381,2024-01-16 21:00:00,8,12,8,8,12,5,53
382,2024-01-16 22:00:00,6,12,14,6,11,8,57
383,2024-01-16 23:00:00,10,8,9,9,10,5,51
384,2024-01-17 00:00:00,12,5,14,7,7,11,56
385,2024-01-17 01:00:00,9,12,10,11,12,9,63
386,2024-01-17 02:00:00,11,12,7,5,7,9,51
387,2024-01-17 03:00:00,5,8,12,5,5,5,40
388,2024-01-17 04:00:00,14,12,9,8,8,10,61
389,2024-01-17 05:00:00,6,10,6,6,9,7,44
390,2024-01-17 06:00:00,14,14,14,5,7,5,59
391,2024-01-17 07:00:00,14,12,14,11,13,14,78
392,2024-01-17 08:00:00,12,11,13,13,8,14,71
393,2024-01-17 09:00:00,12,14,13,11,9,13,72
394,2024-01-17 10:00:00,9,11,8,5,8,7,48
395,2024-01-17 11:00:00,9,14,11,6,8,13,61
396,2024-01-17 12:00:00,14,6,13,7,9,12,61
397,2024-01-17 13:00:00,6,8,11,9,14,5,53
398,2024-01-17 14:00:00,11,7,7,5,7,10,47
399,2024-01-17 15:00:00,14,9,11,12,6,14,66
400,2024-01-17 16:00:00,11,14,13,9,12,5,64
401,2024-01-17 17:00:00,8,13,7,7,6,5,46
402,2024-01-17 18:00:00,14,12,12,7,11,14,70
403,2024-01-17 19:00:00,14,9,11,5,10,6,55
404,2024-01-17 20:00:00,11,8,6,6,7,5,43
405,2024-01-17 21:00:00,5,14,11,12,7,14,63
406,2024-01-17 22:00:00,14,8,13,9,11,11,66
407,2024-01-17 23:00:00,11,5,8,8,9,11,52
408,2024-01-18 00:00:00,9,13,7,9,7,8,53
409,2024-01-18 01:00:00,10,7,11,7,10,7,52
410,2024-01-18 02:00:00,11,6,11,6,13,10,57
411,2024-01-18 03:00:00,10,7,7,13,12,5,54
412,2024-01-18 04:00:00,5,8,6,10,11,14,54
413,2024-01-18 05:00:00,8,10,7,6,8,8,47
414,2024-01-18 06:00:00,5,9,5,9,10,9,47
415,2024-01-18 07:00:00,10,6,12,6,12,13,59
416,2024-01-18 08:00:00,13,5,9,12,8,10,57
417,2024-01-18 09:00:00,11,8,6,12,14,13,64
418,2024-01-18 10:00:00,5,11,12,5,11,10,54
419,2024-01-18 11:00:00,11,11,13,14,10,12,71
420,2024-01-18 12:00:00,11,12,5,13,13,9,63
421,2024-01-18 13:00:00,10,10,13,13,14,8,68
422,2024-01-18 14:00:00,13,12,8,13,13,11,70
423,2024-01-18 15:00:00,7,12,9,9,11,8,56
424,2024-01-18 16:00:00,8,13,10,7,13,8,59
425,2024-01-18 17:00:00,10,5,7,8,8,5,43
426,2024-01-18 18:00:00,12,11,13,14,8,8,66
427,2024-01-18 19:00:00,6,8,5,9,13,12,53
428,2024-01-18 20:00:00,6,6,8,14,13,11,58
429,2024-01-18 21:00:00,9,6,12,8,11,7,53
430,2024-01-18 22:00:00,14,10,6,14,9,7,60
431,2024-01-18 23:00:00,7,10,7,10,8,12,54
432,2024-01-19 00:00:00,5,11,12,10,13,12,63
433,2024-01-19 01:00:00,6,8,11,10,11,10,56
434,2024-01-19 02:00:00,7,12,5,7,8,7,46
435,2024-01-19 03:00:00,9,6,14,5,7,12,53
436,2024-01-19 04:00:00,13,5,8,8,9,14,57
437,2024-01-19 05:00:00,11,9,11,13,7,5,56
438,2024-01-19 06:00:00,6,11,10,12,13,11,63
439,2024-01-19 07:00:00,8,12,13,5,5,6,49
440,2024-01-19 08:00:00,12,12,5,8,8,11,56
441,2024-01-19 09:00:00,6,10,8,13,12,5,54
442,2024-01-19 10:00:00,12,13,11,5,11,10,62
443,2024-01-19 11:00:00,6,12,7,14,7,5,51
444,2024-01-19 12:00:00,6,13,7,11,9,7,53
445,2024-01-19 13:00:00,12,12,14,8,9,13,68
446,2024-01-19 14:00:00,6,12,9,9,9,7,52
447,2024-01-19 15:00:00,14,12,9,12,11,10,68
448,2024-01-19 16:00:00,8,10,5,6,14,13,56
449,2024-01-19 17:00:00,11,13,9,6,10,11,60
450,2024-01-19 18:00:00,12,8,13,5,10,14,62
451,2024-01-19 19:00:00,13,14,6,14,8,12,67
452,2024-01-19 20:00:00,5,8,12,7,10,9,51
453,2024-01-19 21:00:00,13,6,7,14,12,13,65
454,2024-01-19 22:00:00,5,9,7,5,11,13,50
455,2024-01-19 23:00:00,14,7,13,14,11,9,68
456,2024-01-20 00:00:00,6,8,11,14,6,13,58
457,2024-01-20 01:00:00,5,14,13,9,13,5,59
458,2024-01-20 02:00:00,6,11,14,10,13,6,60
459,2024-01-20 03:00:00,13,5,12,13,11,11,65
460,2024-01-20 04:00:00,14,13,8,9,9,8,61
461,2024-01-20 05:00:00,6,9,13,7,12,13,60
462,2024-01-20 06:00:00,13,8,6,13,5,9,54
463,2024-01-20 07:00:00,10,5,14,13,14,12,68
464,2024-01-20 08:00:00,11,5,7,8,10,6,47
465,2024-01-20 09:00:00,5,14,5,7,6,9,46
466,2024-01-20 10:00:00,12,11,9,5,9,11,57
467,2024-01-20 11:00:00,9,7,14,10,9,12,61
468,2024-01-20 12:00:00,13,7,12,7,13,7,59
469,2024-01-20 13:00:00,5,9,14,14,10,11,63
470,2024-01-20 14:00:00,5,14,12,10,13,12,66
471,2024-01-20 15:00:00,13,13,10,14,7,9,66
472,2024-01-20 16:00:00,9,8,14,14,11,14,70
473,2024-01-20 17:00:00,6,9,10,10,12,10,57
474,2024-01-20 18:00:00,11,7,9,12,10,7,56
475,2024-01-20 19:00:00,12,6,11,13,14,12,68
476,2024-01-20 20:00:00,9,10,13,12,11,12,67
477,2024-01-20 21:00:00,13,10,9,11,11,11,65
478,2024-01-20 22:00:00,13,14,13,7,7,14,68
479,2024-01-20 23:00:00,11,10,5,13,14,14,67
480,2024-01-21 00:00:00,6,11,12,12,8,8,57
481,2024-01-21 01:00:00,14,7,6,5,6,7,45
482,2024-01-21 02:00:00,10,10,11,5,13,11,60
483,2024-01-21 03:00:00,8,10,8,11,12,6,55
484,2024-01-21 04:00:00,8,6,7,13,11,9,54
485,2024-01-21 05:00:00,10,8,12,5,5,14,54
486,2024-01-21 06:00:00,5,6,10,8,5,10,44
487,2024-01-21 07:00:00,14,5,5,8,6,9,47
488,2024-01-21 08:00:00,5,12,10,6,8,7,48
489,2024-01-21 09:00:00,14,12,10,7,6,13,62
490,2024-01-21 10:00:00,12,6,10,14,8,12,62
491,2024-01-21 11:00:00,12,12,5,13,9,5,56
492,2024-01-21 12:00:00,5,7,9,9,9,8,47
493,2024-01-21 13:00:00,13,12,8,14,14,10,71
494,2024-01-21 14:00:00,6,7,11,13,14,10,61
495,2024-01-21 15:00:00,11,10,6,5,8,12,52
496,2024-01-21 16:00:00,7,14,5,13,9,6,54
497,2024-01-21 17:00:00,13,7,6,11,10,12,59
498,2024-01-21 18:00:00,10,8,8,7,11,6,50
499,2024-01-21 19:00:00,11,13,11,11,5,12,63
500,2024-01-21 20:00:00,10,14,8,6,7,9,54
501,2024-01-21 21:00:00,5,5,5,9,10,12,46
502,2024-01-21 22:00:00,10,6,10,14,6,7,53
503,2024-01-21 23:00:00,7,12,10,14,11,9,63
504,2024-01-22 00:00:00,12,10,6,8,5,11,52
505,2024-01-22 01:00:00,8,8,8,11,8,7,50
506,2024-01-22 02:00:00,12,10,11,10,10,11,64
507,2024-01-22 03:00:00,14,9,7,13,9,6,58
508,2024-01-22 04:00:00,11,11,7,6,9,6,50
509,2024-01-22 05:00:00,7,9,7,12,12,8,55
510,2024-01-22 06:00:00,14,11,5,12,12,8,62
511,2024-01-22 07:00:00,9,11,14,6,11,10,61
512,2024-01-22 08:00:00,14,11,12,8,8,6,59
513,2024-01-22 09:00:00,11,9,7,9,14,9,59
514,2024-01-22 10:00:00,12,10,5,12,8,5,52
515,2024-01-22 11:00:00,14,7,9,10,13,6,59
516,2024-01-22 12:00:00,11,11,8,11,5,10,56
517,2024-01-22 13:00:00,13,7,5,7,7,6,45
518,2024-01-22 14:00:00,7,6,7,8,13,12,53
519,2024-01-22 15:00:00,14,11,7,13,7,9,61
520,2024-01-22 16:00:00,9,12,12,13,9,13,68
521,2024-01-22 17:00:00,5,7,7,6,10,13,48
522,2024-01-22 18:00:00,11,5,5,5,12,13,51
523,2024-01-22 19:00:00,9,8,13,12,7,14,63
524,2024-01-22 20:00:00,7,11,14,7,8,8,55
525,2024-01-22 21:00:00,14,13,14,6,5,14,66
526,2024-01-22 22:00:00,5,7,6,8,11,9,46
527,2024-01-22 23:00:00,13,13,13,9,5,13,66
528,2024-01-23 00:00:00,7,5,7,5,12,14,50
529,2024-01-23 01:00:00,8,8,11,6,11,14,58
530,2024-01-23 02:00:00,12,6,10,11,8,12,59
531,2024-01-23 03:00:00,5,8,11,6,7,8,45
532,2024-01-23 04:00:00,8,8,13,5,14,8,56
533,2024-01-23 05:00:00,14,11,5,14,8,6,58
534,2024-01-23 06:00:00,11,5,7,10,10,14,57
535,2024-01-23 07:00:00,7,6,5,10,13,14,55
536,2024-01-23 08:00:00,11,5,13,6,7,10,52
537,2024-01-23 09:00:00,6,12,5,10,6,7,46
538,2024-01-23 10:00:00,7,11,9,8,13,13,61
539,2024-01-23 11:00:00,12,7,8,14,8,8,57
540,2024-01-23 12:00:00,5,13,13,11,9,8,59
541,2024-01-23 13:00:00,7,7,10,9,10,6,49
542,2024-01-23 14:00:00,5,13,11,7,9,13,58
543,2024-01-23 15:00:00,6,5,5,5,10,10,41
544,2024-01-23 16:00:00,12,13,14,12,6,13,70
545,2024-01-23 17:00:00,8,5,5,12,6,8,44
546,2024-01-23 18:00:00,6,6,5,9,11,8,45
547,2024-01-23 19:00:00,5,6,14,5,7,6,43
548,2024-01-23 20:00:00,11,7,6,10,12,10,56
549,2024-01-23 21:00:00,5,11,14,14,8,7,59
550,2024-01-23 22:00:00,14,10,8,11,8,8,59
551,2024-01-23 23:00:00,12,6,13,8,14,11,64
552,2024-01-24 00:00:00,5,9,11,12,9,7,53
553,2024-01-24 01:00:00,13,14,14,12,11,6,70
554,2024-01-24 02:00:00,11,13,11,13,11,14,73
555,2024-01-24 03:00:00,5,5,7,13,6,9,45
556,2024-01-24 04:00:00,6,11,13,8,9,7,54
557,2024-01-24 05:00:00,11,5,13,10,13,11,63
558,2024-01-24 06:00:00,10,7,14,12,14,8,65
559,2024-01-24 07:00:00,12,10,8,13,12,8,63
560,2024-01-24 08:00:00,8,9,10,7,6,14,54
561,2024-01-24 09:00:00,11,10,9,13,6,6,55
562,2024-01-24 10:00:00,11,11,6,11,5,10,54
563,2024-01-24 11:00:00,5,9,7,6,6,9,42
564,2024-01-24 12:00:00,10,5,11,9,11,9,55
565,2024-01-24 13:00:00,11,6,8,7,7,9,48
566,2024-01-24 14:00:00,9,7,13,9,11,5,54
567,2024-01-24 15:00:00,8,7,14,9,13,13,64
568,2024-01-24 16:00:00,13,14,14,5,12,12,70
569,2024-01-24 17:00:00,12,14,6,5,6,7,50
570,2024-01-24 18:00:00,6,12,9,10,11,9,57
571,2024-01-24 19:00:00,9,8,5,11,12,12,57
572,2024-01-24 20:00:00,10,14,13,9,9,12,67
573,2024-01-24 21:00:00,6,10,6,7,10,12,51
574,2024-01-24 22:00:00,7,11,7,14,14,6,59
575,2024-01-24 23:00:00,8,6,12,11,9,8,54
576,2024-01-25 00:00:00,12,7,11,13,5,11,59
577,2024-01-25 01:00:00,8,10,8,5,6,13,50
578,2024-01-25 02:00:00,14,14,5,5,14,5,57
579,2024-01-25 03:00:00,14,12,7,11,10,10,64
580,2024-01-25 04:00:00,8,14,11,13,11,8,65
581,2024-01-25 05:00:00,13,12,5,12,6,5,53
582,2024-01-25 06:00:00,8,6,6,5,8,11,44
583,2024-01-25 07:00:00,6,6,10,11,12,9,54
584,2024-01-25 08:00:00,13,12,9,10,6,11,61
585,2024-01-25 09:00:00,11,6,12,12,9,12,62
586,2024-01-25 10:00:00,7,14,9,9,14,7,60
587,2024-01-25 11:00:00,6,7,13,5,9,8,48
588,2024-01-25 12:00:00,10,11,5,8,14,12,60
589,2024-01-25 13:00:00,10,6,8,9,5,11,49
590,2024-01-25 14:00:00,5,5,14,12,9,11,56
591,2024-01-25 15:00:00,11,7,6,14,10,5,53
592,2024-01-25 16:00:00,11,10,7,9,7,8,52
593,2024-01-25 17:00:00,7,7,9,7,5,14,49
594,2024-01-25 18:00:00,14,10,14,13,8,10,69
595,2024-01-25 19:00:00,7,7,9,11,7,13,54
596,2024-01-25 20:00:00,12,8,8,8,6,9,51
597,2024-01-25 21:00:00,9,12,12,8,13,10,64
598,2024-01-25 22:00:00,13,5,8,8,13,8,55
599,2024-01-25 23:00:00,8,10,5,11,10,9,53
600,2024-01-26 00:00:00,13,11,13,8,5,12,62
601,2024-01-26 01:00:00,12,12,13,10,8,6,61
602,2024-01-26 02:00:00,11,13,8,10,14,7,63
603,2024-01-26 03:00:00,5,11,10,7,10,7,50
604,2024-01-26 04:00:00,12,8,8,12,8,5,53
605,2024-01-26 05:00:00,10,13,10,5,14,9,61
606,2024-01-26 06:00:00,9,10,8,14,9,7,57
607,2024-01-26 07:00:00,10,14,5,13,11,8,61
608,2024-01-26 08:00:00,5,7,11,14,5,12,54
609,2024-01-26 09:00:00,9,9,9,14,13,10,64
610,2024-01-26 10:00:00,8,13,10,6,8,7,52
611,2024-01-26 11:00:00,12,7,11,10,10,9,59
612,2024-01-26 12:00:00,7,7,12,11,12,12,61
613,2024-01-26 13:00:00,9,6,8,7,5,10,45
614,2024-01-26 14:00:00,8,9,8,14,11,6,56
615,2024-01-26 15:00:00,12,14,14,11,8,9,68
616,2024-01-26 16:00:00,8,7,12,8,10,13,58
617,2024-01-26 17:00:00,5,12,5,9,7,5,43
618,2024-01-26 18:00:00,9,8,14,11,13,12,67
619,2024-01-26 19:00:00,9,12,11,5,9,8,54
620,2024-01-26 20:00:00,9,6,7,10,12,7,51
621,2024-01-26 21:00:00,12,14,5,5,10,11,57
622,2024-01-26 22:00:00,8,9,14,13,10,7,61
623,2024-01-26 23:00:00,5,7,7,9,12,8,48
624,2024-01-27 00:00:00,12,5,13,14,10,8,62
625,2024-01-27 01:00:00,7,8,12,7,9,7,50
626,2024-01-27 02:00:00,9,7,11,14,8,5,54
627,2024-01-27 03:00:00,10,10,12,11,6,12,61
628,2024-01-27 04:00:00,7,13,8,13,12,7,60
629,2024-01-27 05:00:00,12,12,6,7,13,14,64
630,2024-01-27 06:00:00,8,10,14,11,12,5,60
631,2024-01-27 07:00:00,9,5,13,10,14,8,59
632,2024-01-27 08:00:00,7,10,11,12,10,6,56
633,2024-01-27 09:00:00,10,14,7,6,7,8,52
634,2024-01-27 10:00:00,12,10,12,6,14,7,61
635,2024-01-27 11:00:00,9,10,6,11,13,13,62
636,2024-01-27 12:00:00,9,9,13,9,8,5,53
637,2024-01-27 13:00:00,6,5,9,6,6,10,42
638,2024-01-27 14:00:00,10,7,11,10,5,12,55
639,2024-01-27 15:00:00,10,11,10,8,7,10,56
640,2024-01-27 16:00:00,7,12,13,8,12,13,65
641,2024-01-27 17:00:00,11,10,8,10,14,7,60
642,2024-01-27 18:00:00,10,14,13,14,9,11,71
643,2024-01-27 19:00:00,7,11,11,7,12,10,58
644,2024-01-27 20:00:00,14,9,6,8,13,7,57
645,2024-01-27 21:00:00,8,7,9,14,9,7,54
646,2024-01-27 22:00:00,5,14,5,10,8,13,55
647,2024-01-27 23:00:00,13,10,13,7,13,10,66
648,2024-01-28 00:00:00,7,5,5,8,9,9,43
649,2024-01-28 01:00:00,13,11,11,6,11,10,62
650,2024-01-28 02:00:00,9,9,9,6,10,11,54
651,2024-01-28 03:00:00,13,12,10,9,12,10,66
652,2024-01-28 04:00:00,7,6,5,14,11,12,55
653,2024-01-28 05:00:00,11,11,9,5,10,13,59
654,2024-01-28 06:00:00,5,8,13,11,13,6,56
655,2024-01-28 07:00:00,9,13,7,11,5,6,51
656,2024-01-28 08:00:00,7,5,13,10,13,12,60
657,2024-01-28 09:00:00,14,5,14,6,10,11,60
658,2024-01-28 10:00:00,13,14,11,10,9,9,66
659,2024-01-28 11:00:00,6,7,10,6,9,8,46
660,2024-01-28 12:00:00,7,5,10,11,12,11,56
661,2024-01-28 13:00:00,7,7,10,8,13,10,55
662,2024-01-28 14:00:00,5,10,8,5,9,5,42
663,2024-01-28 15:00:00,8,8,14,13,9,12,64
664,2024-01-28 16:00:00,7,10,7,9,13,10,56
665,2024-01-28 17:00:00,10,5,14,7,11,5,52
666,2024-01-28 18:00:00,10,11,8,8,7,10,54
667,2024-01-28 19:00:00,6,11,5,6,9,5,42
668,2024-01-28 20:00:00,10,6,8,9,14,13,60
669,2024-01-28 21:00:00,9,11,6,13,7,13,59
670,2024-01-28 22:00:00,6,7,10,9,14,10,56
671,2024-01-28 23:00:00,14,13,11,8,7,10,63
672,2024-01-29 00:00:00,6,7,13,13,10,12,61
673,2024-01-29 01:00:00,7,10,14,11,11,10,63
674,2024-01-29 02:00:00,14,6,14,13,5,7,59
675,2024-01-29 03:00:00,5,12,11,12,11,14,65
676,2024-01-29 04:00:00,6,5,9,10,11,12,53
677,2024-01-29 05:00:00,11,11,14,10,10,5,61
678,2024-01-29 06:00:00,10,9,5,5,6,13,48
679,2024-01-29 07:00:00,9,12,10,9,14,9,63
680,2024-01-29 08:00:00,5,8,11,8,11,8,51
681,2024-01-29 09:00:00,5,12,12,9,5,9,52
682,2024-01-29 10:00:00,9,5,9,12,6,12,53
683,2024-01-29 11:00:00,14,7,5,5,12,13,56
684,2024-01-29 12:00:00,14,6,8,7,13,12,60
685,2024-01-29 13:00:00,6,8,13,7,10,10,54
686,2024-01-29 14:00:00,6,7,8,11,14,9,55
687,2024-01-29 15:00:00,14,7,11,6,12,9,59
688,2024-01-29 16:00:00,10,10,7,6,7,12,52
689,2024-01-29 17:00:00,9,8,8,14,9,11,59
690,2024-01-29 18:00:00,9,7,14,7,6,5,48
691,2024-01-29 19:00:00,14,10,12,12,11,14,73
692,2024-01-29 20:00:00,6,10,14,8,12,13,63
693,2024-01-29 21:00:00,8,13,5,5,11,6,48
694,2024-01-29 22:00:00,6,10,5,10,8,12,51
695,2024-01-29 23:00:00,11,11,8,5,5,14,54
696,2024-01-30 00:00:00,12,9,7,5,8,5,46
697,2024-01-30 01:00:00,6,12,5,9,13,14,59
698,2024-01-30 02:00:00,11,7,13,5,7,5,48
699,2024-01-30 03:00:00,5,11,11,7,9,11,54
700,2024-01-30 04:00:00,7,5,7,13,11,9,52
701,2024-01-30 05:00:00,14,7,6,10,11,13,61
702,2024-01-30 06:00:00,5,13,13,5,8,13,57
703,2024-01-30 07:00:00,13,9,6,6,11,12,57
704,2024-01-30 08:00:00,6,8,14,14,11,12,65
705,2024-01-30 09:00:00,8,7,13,8,10,6,52
706,2024-01-30 10:00:00,14,6,14,9,6,8,57
707,2024-01-30 11:00:00,8,11,7,13,13,8,60
708,2024-01-30 12:00:00,10,13,9,11,13,8,64
709,2024-01-30 13:00:00,9,11,8,7,5,14,54
710,2024-01-30 14:00:00,8,14,7,10,7,9,55
711,2024-01-30 15:00:00,12,14,11,7,14,6,64
712,2024-01-30 16:00:00,9,10,10,9,10,13,61
713,2024-01-30 17:00:00,7,8,11,12,13,10,61
714,2024-01-30 18:00:00,13,11,11,11,12,13,71
715,2024-01-30 19:00:00,8,5,6,14,11,13,57
716,2024-01-30 20:00:00,13,10,10,6,11,7,57
717,2024-01-30 21:00:00,6,11,12,7,6,6,48
718,2024-01-30 22:00:00,5,6,8,7,14,7,47
719,2024-01-30 23:00:00,10,10,13,14,14,6,67
720,2024-01-31 00:00:00,6,6,10,14,6,10,52
721,2024-01-31 01:00:00,13,7,11,8,10,10,59
722,2024-01-31 02:00:00,6,10,9,13,14,11,63
723,2024-01-31 03:00:00,9,9,6,5,11,7,47
724,2024-01-31 04:00:00,5,6,14,12,7,6,50
725,2024-01-31 05:00:00,8,7,5,13,12,5,50
726,2024-01-31 06:00:00,14,14,9,13,7,13,70
727,2024-01-31 07:00:00,12,5,5,12,6,7,47
728,2024-01-31 08:00:00,5,6,10,11,9,9,50
729,2024-01-31 09:00:00,11,5,11,9,5,10,51
730,2024-01-31 10:00:00,12,13,11,14,14,5,69
731,2024-01-31 11:00:00,5,12,6,6,7,10,46
732,2024-01-31 12:00:00,12,6,8,10,12,6,54
733,2024-01-31 13:00:00,13,10,12,14,12,8,69
734,2024-01-31 14:00:00,12,13,9,6,12,5,57
735,2024-01-31 15:00:00,7,10,11,13,9,5,55
736,2024-01-31 16:00:00,11,10,7,7,11,12,58
737,2024-01-31 17:00:00,11,12,9,6,8,9,55
738,2024-01-31 18:00:00,11,13,7,10,12,8,61
739,2024-01-31 19:00:00,9,9,11,7,6,5,47
740,2024-01-31 20:00:00,14,12,7,7,11,12,63
741,2024-01-31 21:00:00,7,13,11,11,12,5,59
742,2024-01-31 22:00:00,10,9,12,14,6,10,61
743,2024-01-31 23:00:00,6,10,9,10,7,11,53
744,2024-02-01 00:00:00,10,13,13,10,7,8,61
745,2024-02-01 01:00:00,8,14,10,10,12,8,62
746,2024-02-01 02:00:00,11,13,11,14,11,14,74
747,2024-02-01 03:00:00,5,7,10,12,8,10,52
748,2024-02-01 04:00:00,8,6,11,14,7,7,53
749,2024-02-01 05:00:00,6,13,5,7,11,5,47
750,2024-02-01 06:00:00,6,5,10,9,6,11,47
751,2024-02-01 07:00:00,13,14,10,13,5,7,62
752,2024-02-01 08:00:00,10,5,7,11,8,7,48
753,2024-02-01 09:00:00,6,6,5,13,10,6,46
754,2024-02-01 10:00:00,7,14,7,6,7,11,52
755,2024-02-01 11:00:00,9,10,10,10,7,6,52
756,2024-02-01 12:00:00,9,5,9,5,12,5,45
757,2024-02-01 13:00:00,8,14,11,12,9,5,59
758,2024-02-01 14:00:00,11,6,8,7,9,5,46
759,2024-02-01 15:00:00,11,14,13,10,5,10,63
760,2024-02-01 16:00:00,9,5,13,9,7,8,51
761,2024-02-01 17:00:00,5,12,5,11,14,14,61
762,2024-02-01 18:00:00,10,5,12,12,10,8,57
763,2024-02-01 19:00:00,10,7,10,9,13,6,55
764,2024-02-01 20:00:00,14,14,10,14,6,9,67
765,2024-02-01 21:00:00,10,11,12,8,9,8,58
766,2024-02-01 22:00:00,10,13,14,14,6,5,62
767,2024-02-01 23:00:00,11,7,13,14,13,7,65
768,2024-02-02 00:00:00,13,12,12,13,7,5,62
769,2024-02-02 01:00:00,8,7,7,12,9,6,49
770,2024-02-02 02:00:00,7,13,8,7,13,8,56
771,2024-02-02 03:00:00,6,5,7,7,8,9,42
772,2024-02-02 04:00:00,12,9,7,10,10,7,55
773,2024-02-02 05:00:00,5,10,9,8,6,6,44
774,2024-02-02 06:00:00,8,13,14,10,6,8,59
775,2024-02-02 07:00:00,10,12,5,11,10,9,57
776,2024-02-02 08:00:00,7,9,14,10,12,10,62
777,2024-02-02 09:00:00,10,10,5,8,12,5,50
778,2024-02-02 10:00:00,6,9,8,9,9,11,52
779,2024-02-02 11:00:00,6,8,9,12,10,14,59
780,2024-02-02 12:00:00,12,8,12,7,11,9,59
781,2024-02-02 13:00:00,10,14,7,6,7,5,49
782,2024-02-02 14:00:00,7,13,11,10,14,6,61
783,2024-02-02 15:00:00,11,13,10,6,12,10,62
784,2024-02-02 16:00:00,13,11,12,10,7,7,60
785,2024-02-02 17:00:00,9,9,12,11,14,10,65
786,2024-02-02 18:00:00,14,10,7,8,7,5,51
787,2024-02-02 19:00:00,6,7,12,12,10,11,58
788,2024-02-02 20:00:00,6,11,7,12,8,5,49
789,2024-02-02 21:00:00,13,9,14,7,5,12,60
790,2024-02-02 22:00:00,14,12,10,10,6,6,58
791,2024-02-02 23:00:00,8,7,9,6,12,8,50
792,2024-02-03 00:00:00,11,9,8,12,12,12,64
793,2024-02-03 01:00:00,10,7,12,12,11,10,62
794,2024-02-03 02:00:00,8,11,8,14,9,5,55
795,2024-02-03 03:00:00,11,6,8,13,9,11,58
796,2024-02-03 04:00:00,6,14,11,6,14,13,64
797,2024-02-03 05:00:00,13,12,11,13,6,8,63
798,2024-02-03 06:00:00,14,6,8,13,9,8,58
799,2024-02-03 07:00:00,13,9,12,14,12,5,65
800,2024-02-03 08:00:00,7,8,9,10,11,7,52
801,2024-02-03 09:00:00,14,11,5,13,11,12,66
802,2024-02-03 10:00:00,5,9,12,11,7,6,50
803,2024-02-03 11:00:00,7,7,5,14,5,7,45
804,2024-02-03 12:00:00,13,5,13,10,12,11,64
805,2024-02-03 13:00:00,14,9,5,6,6,11,51
806,2024-02-03 14:00:00,6,7,8,7,6,14,48
807,2024-02-03 15:00:00,5,14,13,10,14,8,64
808,2024-02-03 16:00:00,7,12,12,11,13,5,60
809,2024-02-03 17:00:00,14,8,6,7,12,13,60
810,2024-02-03 18:00:00,11,10,5,7,10,6,49
811,2024-02-03 19:00:00,13,13,12,10,10,13,71
812,2024-02-03 20:00:00,13,5,9,9,13,14,63
813,2024-02-03 21:00:00,14,14,14,12,8,6,68
814,2024-02-03 22:00:00,6,5,12,11,11,8,53
815,2024-02-03 23:00:00,9,6,7,8,11,13,54
816,2024-02-04 00:00:00,12,7,9,9,14,10,61
817,2024-02-04 01:00:00,10,8,9,14,14,11,66
818,2024-02-04 02:00:00,14,7,10,14,6,10,61
819,2024-02-04 03:00:00,13,14,9,13,11,5,65
820,2024-02-04 04:00:00,10,10,8,5,14,14,61
821,2024-02-04 05:00:00,12,7,11,10,11,5,56
822,2024-02-04 06:00:00,6,5,8,10,6,10,45
823,2024-02-04 07:00:00,11,6,11,5,11,12,56
824,2024-02-04 08:00:00,12,14,13,14,6,10,69
825,2024-02-04 09:00:00,5,10,12,12,11,12,62
826,2024-02-04 10:00:00,5,8,9,9,7,8,46
827,2024-02-04 11:00:00,5,7,8,13,11,5,49
828,2024-02-04 12:00:00,10,8,14,12,5,5,54
829,2024-02-04 13:00:00,14,11,9,7,7,10,58
830,2024-02-04 14:00:00,13,9,13,5,6,7,53
831,2024-02-04 15:00:00,14,12,11,5,8,14,64
832,2024-02-04 16:00:00,14,7,11,8,5,13,58
833,2024-02-04 17:00:00,8,8,12,10,5,7,50
834,2024-02-04 18:00:00,8,10,7,5,8,11,49
835,2024-02-04 19:00:00,12,5,10,11,8,9,55
836,2024-02-04 20:00:00,8,8,8,10,14,7,55
837,2024-02-04 21:00:00,5,8,12,14,14,5,58
838,2024-02-04 22:00:00,14,12,10,7,9,13,65
839,2024-02-04 23:00:00,6,14,7,13,5,7,52
840,2024-02-05 00:00:00,10,9,12,6,8,6,51
841,2024-02-05 01:00:00,13,6,8,6,10,8,51
842,2024-02-05 02:00:00,9,13,8,6,6,12,54
843,2024-02-05 03:00:00,6,11,12,8,10,13,60
844,2024-02-05 04:00:00,14,12,8,11,11,9,65
845,2024-02-05 05:00:00,13,9,11,5,8,9,55
846,2024-02-05 06:00:00,10,7,5,9,10,14,55
847,2024-02-05 07:00:00,6,9,5,14,11,7,52
848,2024-02-05 08:00:00,14,8,13,8,7,8,58
849,2024-02-05 09:00:00,7,14,7,6,8,8,50
850,2024-02-05 10:00:00,9,9,14,5,7,13,57
851,2024-02-05 11:00:00,10,8,8,13,5,10,54
852,2024-02-05 12:00:00,10,6,7,14,9,12,58
853,2024-02-05 13:00:00,5,10,12,12,5,14,58
854,2024-02-05 14:00:00,7,13,13,5,8,11,57
855,2024-02-05 15:00:00,6,6,5,12,11,11,51
856,2024-02-05 16:00:00,13,11,9,9,11,10,63
857,2024-02-05 17:00:00,11,6,14,7,9,6,53
858,2024-02-05 18:00:00,7,11,7,8,10,14,57
859,2024-02-05 19:00:00,10,9,9,13,9,7,57
860,2024-02-05 20:00:00,5,8,12,6,12,14,57
861,2024-02-05 21:00:00,6,7,7,6,12,10,48
862,2024-02-05 22:00:00,5,13,11,9,6,9,53
863,2024-02-05 23:00:00,14,9,10,14,9,14,70
864,2024-02-06 00:00:00,14,5,10,13,13,5,60
865,2024-02-06 01:00:00,14,13,7,5,14,11,64
866,2024-02-06 02:00:00,5,10,11,9,10,12,57
867,2024-02-06 03:00:00,14,12,8,12,5,13,64
868,2024-02-06 04:00:00,6,9,7,10,6,5,43
869,2024-02-06 05:00:00,13,7,7,13,5,9,54
870,2024-02-06 06:00:00,9,11,5,13,11,5,54
871,2024-02-06 07:00:00,11,6,7,5,14,6,49
872,2024-02-06 08:00:00,14,7,6,9,12,6,54
873,2024-02-06 09:00:00,14,9,10,6,14,7,60
874,2024-02-06 10:00:00,14,7,6,10,10,7,54
875,2024-02-06 11:00:00,13,13,13,6,11,7,63
876,2024-02-06 12:00:00,14,14,8,10,11,7,64
877,2024-02-06 13:00:00,7,14,8,6,7,5,47
878,2024-02-06 14:00:00,8,10,13,9,5,14,59
879,2024-02-06 15:00:00,12,7,11,10,7,7,54
880,2024-02-06 16:00:00,11,11,10,14,5,14,65
881,2024-02-06 17:00:00,7,6,8,9,11,12,53
882,2024-02-06 18:00:00,12,8,8,13,9,8,58
883,2024-02-06 19:00:00,10,13,5,12,7,9,56
884,2024-02-06 20:00:00,5,12,6,12,9,7,51
885,2024-02-06 21:00:00,11,13,10,13,14,10,71
886,2024-02-06 22:00:00,8,9,6,9,12,12,56
887,2024-02-06 23:00:00,7,7,12,10,9,5,50
888,2024-02-07 00:00:00,13,12,10,10,6,9,60
889,2024-02-07 01:00:00,6,8,7,14,14,14,63
890,2024-02-07 02:00:00,12,12,13,14,13,8,72
891,2024-02-07 03:00:00,11,6,8,5,11,12,53
892,2024-02-07 04:00:00,12,8,12,13,6,13,64
893,2024-02-07 05:00:00,7,5,11,8,14,10,55
894,2024-02-07 06:00:00,9,6,13,7,11,6,52
895,2024-02-07 07:00:00,13,6,8,8,13,12,60
896,2024-02-07 08:00:00,10,6,12,6,5,12,51
897,2024-02-07 09:00:00,8,14,13,10,12,7,64
898,2024-02-07 10:00:00,7,8,7,11,6,14,53
899,2024-02-07 11:00:00,14,14,8,12,9,6,63
900,2024-02-07 12:00:00,8,6,13,7,11,7,52
901,2024-02-07 13:00:00,10,10,7,12,9,6,54
902,2024-02-07 14:00:00,7,8,6,14,11,14,60
903,2024-02-07 15:00:00,7,14,7,6,13,6,53
904,2024-02-07 16:00:00,5,5,11,14,7,5,47
905,2024-02-07 17:00:00,6,13,8,9,13,5,54
906,2024-02-07 18:00:00,9,13,13,14,5,13,67
907,2024-02-07 19:00:00,6,7,6,6,14,8,47
908,2024-02-07 20:00:00,14,13,8,8,9,11,63
909,2024-02-07 21:00:00,6,11,7,7,5,7,43
910,2024-02-07 22:00:00,6,7,13,8,10,12,56
911,2024-02-07 23:00:00,8,10,12,5,11,5,51
912,2024-02-08 00:00:00,6,14,10,14,8,13,65
913,2024-02-08 01:00:00,5,14,9,6,8,8,50
914,2024-02-08 02:00:00,10,10,7,5,12,7,51
915,2024-02-08 03:00:00,5,14,12,6,5,12,54
916,2024-02-08 04:00:00,12,6,9,10,8,13,58
917,2024-02-08 05:00:00,14,12,9,10,6,8,59
918,2024-02-08 06:00:00,5,6,13,14,11,5,54
919,2024-02-08 07:00:00,9,6,7,6,14,10,52
920,2024-02-08 08:00:00,10,12,6,7,10,6,51
921,2024-02-08 09:00:00,11,12,8,10,13,14,68
922,2024-02-08 10:00:00,13,10,14,6,11,13,67
923,2024-02-08 11:00:00,11,13,13,9,13,5,64
924,2024-02-08 12:00:00,11,7,5,12,7,11,53
925,2024-02-08 13:00:00,8,10,14,8,7,6,53
926,2024-02-08 14:00:00,14,6,9,14,12,7,62
927,2024-02-08 15:00:00,13,10,6,10,14,9,62
928,2024-02-08 16:00:00,12,13,6,11,11,6,59
929,2024-02-08 17:00:00,6,7,11,7,7,14,52
930,2024-02-08 18:00:00,7,9,13,13,11,10,63
931,2024-02-08 19:00:00,12,14,7,6,6,7,52
932,2024-02-08 20:00:00,13,8,11,13,7,5,57
933,2024-02-08 21:00:00,8,13,11,5,9,10,56
934,2024-02-08 22:00:00,5,9,10,6,14,13,57
935,2024-02-08 23:00:00,9,5,5,14,12,9,54
936,2024-02-09 00:00:00,5,11,12,7,12,10,57
937,2024-02-09 01:00:00,14,5,9,5,10,11,54
938,2024-02-09 02:00:00,12,10,8,13,6,7,56
939,2024-02-09 03:00:00,5,9,9,10,8,7,48
940,2024-02-09 04:00:00,5,9,7,10,13,8,52
941,2024-02-09 05:00:00,14,10,12,5,6,7,54
942,2024-02-09 06:00:00,11,7,13,8,10,13,62
943,2024-02-09 07:00:00,5,5,8,8,13,12,51
944,2024-02-09 08:00:00,14,7,11,11,6,7,56
945,2024-02-09 09:00:00,13,12,13,14,6,11,69
946,2024-02-09 10:00:00,8,7,13,8,13,12,61
947,2024-02-09 11:00:00,13,11,11,13,12,14,74
948,2024-02-09 12:00:00,7,14,7,12,9,6,55
949,2024-02-09 13:00:00,8,13,11,6,13,14,65
950,2024-02-09 14:00:00,6,6,12,8,11,11,54
951,2024-02-09 15:00:00,14,10,5,12,5,8,54
952,2024-02-09 16:00:00,5,11,13,10,8,9,56
953,2024-02-09 17:00:00,5,14,14,14,10,7,64
954,2024-02-09 18:00:00,9,12,6,14,13,5,59
955,2024-02-09 19:00:00,6,13,8,8,8,8,51
956,2024-02-09 20:00:00,10,14,5,11,7,12,59
957,2024-02-09 21:00:00,10,13,9,12,8,9,61
958,2024-02-09 22:00:00,12,10,12,14,11,13,72
959,2024-02-09 23:00:00,10,14,6,10,14,9,63
960,2024-02-10 00:00:00,7,7,11,14,11,5,55
961,2024-02-10 01:00:00,6,12,5,8,11,13,55
962,2024-02-10 02:00:00,7,13,5,12,9,7,53
963,2024-02-10 03:00:00,11,5,14,11,10,9,60
964,2024-02-10 04:00:00,10,14,13,8,9,11,65
965,2024-02-10 05:00:00,8,6,10,14,13,13,64
966,2024-02-10 06:00:00,13,5,11,7,14,7,57
967,2024-02-10 07:00:00,7,9,7,9,5,6,43
968,2024-02-10 08:00:00,12,14,13,5,14,10,68
969,2024-02-10 09:00:00,14,14,13,14,14,6,75
970,2024-02-10 10:00:00,7,7,13,9,6,8,50
971,2024-02-10 11:00:00,14,6,14,10,13,6,63
972,2024-02-10 12:00:00,5,12,14,6,13,7,57
973,2024-02-10 13:00:00,7,13,9,10,11,5,55
974,2024-02-10 14:00:00,7,10,14,5,14,9,59
975,2024-02-10 15:00:00,8,13,9,6,11,8,55
976,2024-02-10 16:00:00,5,13,6,13,5,8,50
977,2024-02-10 17:00:00,8,5,12,11,9,6,51
978,2024-02-10 18:00:00,14,7,14,7,8,14,64
979,2024-02-10 19:00:00,14,7,8,12,11,12,64
980,2024-02-10 20:00:00,11,13,7,11,11,8,61
981,2024-02-10 21:00:00,14,5,12,14,12,8,65
982,2024-02-10 22:00:00,12,12,5,7,7,14,57
983,2024-02-10 23:00:00,13,10,10,11,14,10,68
984,2024-02-11 00:00:00,10,12,7,14,10,12,65
985,2024-02-11 01:00:00,10,12,7,9,10,11,59
986,2024-02-11 02:00:00,13,8,10,11,9,6,57
987,2024-02-11 03:00:00,6,6,8,10,7,14,51
988,2024-02-11 04:00:00,10,12,12,7,8,5,54
989,2024-02-11 05:00:00,11,10,7,14,5,11,58
990,2024-02-11 06:00:00,14,14,5,6,11,7,57
991,2024-02-11 07:00:00,11,9,9,11,9,14,63
992,2024-02-11 08:00:00,9,12,9,12,14,8,64
993,2024-02-11 09:00:00,13,10,9,10,10,5,57
994,2024-02-11 10:00:00,10,8,12,11,7,8,56
995,2024-02-11 11:00:00,11,6,13,14,8,8,60
996,2024-02-11 12:00:00,8,13,10,6,9,9,55
997,2024-02-11 13:00:00,8,12,10,12,11,12,65
998,2024-02-11 14:00:00,14,11,13,12,11,11,72
999,2024-02-11 15:00:00,8,10,8,10,13,14,63
